Zinnen met 'op' erin
Een vrouw is aan het wakeboarden op een meer	Een vrouw is op een meer aan het wakeboarden
De bruine honden zijn speels aan het vechten op de zandkust	De bruine honden zijn speels op de zandkust aan het vechten
Iemand is aan het typen op een toetsenbord	Iemand is op een toetsenbord aan het typen
Een kind in een rode outfit is gevaarlijk aan het springen op een trampoline	Een kind in een rode outfit is gevaarlijk op een trampoline aan het springen
Twee voetballers zijn aan het klauteren voor de bal op het veld	Twee voetballers zijn op het veld aan het klauteren voor de bal
De bruine honden zijn niet speels aan het vechten op het zandstrand	De bruine honden zijn niet speels op het zandstrand aan het vechten
Een zwarte man is aan het breakdansen op de stoep	Een zwarte man is op de stoep aan het breakdansen
Er is geen beroemde zanger op het plafond aan het dansen	Er is geen beroemde zanger aan het dansen op het plafond
De man is de tekening op het bord aan het uitwissen	De man is de tekening aan het uitwissen op het bord
Een man is langzaam aan het dansen op de weg	Een man is langzaam op de weg aan het dansen
Een meisje is aan het skateboarden op een halfpipe	Een meisje is op een halfpipe aan het skateboarden
Twee lange basketbalspelers zijn aan het klauteren voor de bal op het veld	Twee lange basketbalspelers zijn op het veld aan het klauteren voor de bal
Een bruine hond en een rode hond zijn op het strand aan het dartelen	Een bruine hond en een rode hond zijn aan het dartelen op het strand
Een vrouw is aan het wakeboarden op het meer	Een vrouw is op het meer aan het wakeboarden
De jongen is aan het draven op het paard	De jongen is op het paard aan het draven
Een man is aan het skateboarden op een halfpipe	Een man is op een halfpipe aan het skateboarden
Er is geen hond aan het racen op een parcours	Er is geen hond op een parcours aan het racen
Een zwarte man is vakkundig op de stoep aan het breakdansen	Een zwarte man is vakkundig aan het breakdansen op de stoep
Een zwarte hond en een witte hond zijn aan het worstelen op het bed	Een zwarte hond en een witte hond zijn op het bed aan het worstelen
Iemand is aan het typen op het toetsenbord	Iemand is op het toetsenbord aan het typen
De bruine hond en de rode hond zijn aan het dartelen op het strand	De bruine hond en de rode hond zijn op het strand aan het dartelen
Twee vrouwen dragen bikini's en zijn op het zand aan het lopen	Twee vrouwen dragen bikini's en zijn aan het lopen op het zand
Twee grote honden zijn aan het dartelen op een parkeerplaats	Twee grote honden zijn op een parkeerplaats aan het dartelen
De bruine honden zijn speels aan het vechten op het zandstrand	De bruine honden zijn speels op het zandstrand aan het vechten
Een jongen is aan het skateboarden op een halfpipe	Een jongen is op een halfpipe aan het skateboarden
Er is geen man op de fiets op het strand aan het rijden	Er is geen man op de fiets aan het rijden op het strand
Er is geen man op de fiets op het strand aan het rijden	Er is geen man op het strand op de fiets aan het rijden DUPLICATE
Twee honden zijn vrolijk samen aan het spelen op het gras	Twee honden zijn vrolijk samen op het gras aan het spelen
Twee kinderen zijn aan het strekken op een aantal metalen staven	Twee kinderen zijn op een aantal metalen staven aan het strekken
Vier honden zijn niet aan het spelen op een grasveld	Vier honden zijn niet op een grasveld aan het spelen
De vrouw is niet op de gitaar, die akoestisch is, aan het spelen, of aan het zingen	De vrouw is niet aan het spelen op de gitaar, die akoestisch is, of aan het zingen
Het meisje is aan het draven op het paard	Het meisje is op het paard aan het draven
Twee basketbalspelers zijn aan het klauteren voor de bal op het veld	Twee basketbalspelers zijn op het veld aan het klauteren voor de bal
De man is aan het typen op een machine die gebruikt wordt voor stenografie	De man is op een machine aan het typen die gebruikt wordt voor stenografie
