Zinnen met 'in' erin
Een verre persoon met een blauwe rugzak is aan het wandelen in rotsachtig gebied	Een verre persoon met een blauwe rugzak is in rotsachtig gebied aan het wandelen
Twee honden zijn aan het dartelen in de sneeuw	Twee honden zijn in de sneeuw aan het dartelen
Twee meisjes zijn gelukkig aan het spelen in een springkasteel	Twee meisjes zijn gelukkig in een springkasteel aan het spelen
De mannen zijn niet aan het knokken in een ring	De mannen zijn niet in een ring aan het knokken
Een hond is opgewonden aan het spelen met water in een veld	Een hond is opgewonden in een veld aan het spelen met water
De mannen zijn aan het knokken in een ring	De mannen zijn in een ring aan het knokken
Een hond is opgewonden aan het spelen met water in het gras	Een hond is opgewonden in het gras aan het spelen met water
Een kind in een rode outfit is gevaarlijk aan het springen op een trampoline	Een kind in een rode outfit is gevaarlijk op een trampoline aan het springen
Twee kinderen zijn aan het voetballen in het park	Twee kinderen zijn in het park aan het voetballen
Een paar zwemmers zijn aan het racen in een meer	Een paar zwemmers zijn in een meer aan het racen
De man is aan het zwemmen in een waterlichaam bij een waterval	De man is in een waterlichaam bij een waterval aan het zwemmen
Een kind is aan het buikschuiven in het gras	Een kind is in het gras aan het buikschuiven
Twee mannen zijn aan het knokken in een ring	Twee mannen zijn in een ring aan het knokken
De hond is aan het uitrusten in de woonkamer	De hond is in de woonkamer aan het uitrusten
Twee mannen zijn aan het vechten in een veehouderij	Twee mannen zijn in een veehouderij aan het vechten
De man is vrolijk aan het wandelen in het bos	De man is vrolijk in het bos aan het wandelen
De man is aan het wandelen in het bos	De man is in het bos aan het wandelen
Een jongen is aan het buikschuiven in het gras	Een jongen is in het gras aan het buikschuiven
De hond is aan het uitrusten in het park	De hond is in het park aan het uitrusten
Een kind is niet aan het buikschuiven in het gras	Een kind is niet in het gras aan het buikschuiven
Twee grote honden zijn aan het dartelen in een grasveld	Twee grote honden zijn in een grasveld aan het dartelen
Twee grote honden zijn aan het stoeien in een veld	Twee grote honden zijn in een veld aan het stoeien
Een man is aan het wandelen in het bos	Een man is in het bos aan het wandelen
Twee jongens liggen in de oceaan tot ver aan het strand	Twee jongens liggen tot ver aan het strand in de oceaan
Niemand is aan het knokken in een ring	Niemand is in een ring aan het knokken
Een bruine hond en een zwarte hond zijn aan het dartelen in het zand	Een bruine hond en een zwarte hond zijn in het zand aan het dartelen
Een bruine en witte hond is aan het rusten in het gras	Een bruine en witte hond is in het gras aan het rusten
De man is niet aan het wandelen in het bos	De man is niet in het bos aan het wandelen
Een persoon is een reling af aan het snowboarden in de sneeuw	Een persoon is in de sneeuw een reling af aan het snowboarden
Een man is aan het touwtje springen in een veld	Een man is in een veld aan het touwtje springen
Een man is langzaam aan het wandelen in het bos	Een man is in het bos langzaam aan het wandelen
Twee mensen zijn aan het knokken in een ring	Twee mensen zijn in een ring aan het knokken
