Zinnen met 'met' erin
De man is onhandig met een trainer aan het kickboksen	De man is onhandig aan het kickboksen met een trainer
Een hond is opgewonden aan het spelen met water in een veld	Een hond is opgewonden met water aan het spelen in een veld DUPLICATE
Iemand is wat papier aan het knippen met een schaar	Iemand is met een schaar wat papier aan het knippen
Een hond is opgewonden aan het spelen met water in het gras	Een hond is opgewonden met water aan het spelen in het gras DUPLICATE
Iemand is een cameralens aan het spijkeren met luide knallen	Iemand is met luide knallen een cameralens aan het spijkeren
Een persoon is snel champignons aan het hakken met een mes	Een persoon is met een mes snel champignons aan het hakken
Een man is snel wat champignons aan het hakken met een mes	Een man is met een mes snel wat champignons aan het hakken
De jongen is het gras aan het inkorten bij de stoep met een schaar	De jongen is met een schaar het gras aan het inkorten bij de stoep
Een kerel is vrolijk aan het spelen met de hacky sack	Een kerel is vrolijk met de hacky sack aan het spelen
Een kat is aan het spelen met een watermeloen	Een kat is met een watermeloen aan het spelen
Een vrouw is aan het tornen met een machine	Een vrouw is met een machine aan het tornen
Twee preadolescente tweelingkinderen zijn aan het duelleren met stokken	Twee preadolescente tweelingkinderen zijn met stokken aan het duelleren
Een persoon is niet snel champignons aan het hakken met een mes	Een persoon is niet met een mes snel champignons aan het hakken
Een kerel is vrolijk aan het spelen met een hacky sack	Een kerel is vrolijk met een hacky sack aan het spelen
De jongen is niet het gras bij de stoeprand met een schaar aan het maaien	De jongen is niet het gras bij de stoeprand aan het maaien met een schaar
Een man is vlug wat champignons aan het hakken met een mes	Een man is met een mes vlug wat champignons aan het hakken
Iemand is iets aan het noteren met een potlood	Iemand is met een potlood iets aan het noteren
De man is niet aan het kickboksen met een trainer	De man is niet met een trainer aan het kickboksen
De man is een boomstam aan het hakken met een bijl	De man is met een bijl een boomstam aan het hakken
De kat is aan het spelen met een watermeloen	De kat is met een watermeloen aan het spelen
Een baby is vrolijk aan het spelen met een hond	Een baby is vrolijk met een hond aan het spelen
