Een jongen is het gazon aan het maaien	Een jongen maait het gazon
Een hond, die groot en grijs is, is moeizaam een bal in zijn bek aan het dragen en over het gras aan het rennen	Een hond, die groot en grijs is, draagt moeizaam een bal in zijn bek en rent over het gras
Een man is snel wat champignons aan het hakken met een mes	Een man hakt snel wat champignons met een mes
De vrouw is een kangoeroe aan het oppakken die klein is	De vrouw pakt een kangoeroe op die klein is
Een persoon is aan het spugen	Een persoon spuugt
De hond, die zwart-wit is, is aan het rennen en er staat een persoon achter	De hond, die zwart-wit is, rent en er staat een persoon achter
Een grote hond en een kleine hond met een witte vacht zijn samen aan het spelen	Een grote hond en een kleine hond met een witte vacht spelen samen
De kinderen van een familie zijn geduldig aan het spelen en wachten	De kinderen van een familie spelen en wachten geduldig
Een groep jongens in een tuin is aan het spelen en een man staat op de achtergrond	Een groep jongens in een tuin speelt en een man staat op de achtergrond
Er is geen vrouw die een vis aan het doorsnijden is	Er is geen vrouw die een vis doorsnijdt
Drie Aziatische kinderen zijn aan het dansen en er is geen man die kijkt	Drie Aziatische kinderen dansen en er is geen man die kijkt
Een vrouw is groenten in schijfjes aan het snijden	Een vrouw snijdt groenten in schijfjes
De jongen is het gras aan het inkorten bij de stoep met een schaar	De jongen kort het gras in bij de stoep met een schaar
Iemand is wat uien in schijfjes aan het snijden	Iemand snijdt wat uien in schijfjes
Een vrouw is broccoli aan het hakken	Een vrouw hakt broccoli
Twee mannen zijn aan het vechten in een veehouderij	Twee mannen vechten in een veehouderij
De man met een helm is aan het dansen	De man met een helm danst
De man is vrolijk aan het wandelen in het bos	De man wandelt vrolijk in het bos
De man is aan het sporten	De man sport
Een kind is niet aan het buikschuiven in het gras	Een kind buikschuift in het gras
Een paar mensen zijn aan het dansen	Een paar mensen dansen
Een kind is een sneeuwbal aan het verpletteren	Een kind verplettert een sneeuwbal
De vrouw is sap aan het persen uit een citroen	De vrouw perst sap uit een citroen
Mannen zijn houtblokken aan het zagen	Mannen zagen houtblokken
Een groep honden is aan het racen en heeft een muilkorf op de neus	Een groep honden racet en heeft een muilkorf op de neus
Twee vrouwen zijn aan het dansen	Twee vrouwen dansen
Een vrouw is twee eieren naar een breakdanser aan het bowlen	Een vrouw bowlt twee eieren naar een breakdanser
Een persoon is een tortilla aan het vouwen	Een persoon vouwt een tortilla
Een meisje draagt een spijkerbroek en een roze overhemd en is vrolijk aan het rennen	Een meisje draagt een spijkerbroek en een roze overhemd en rent vrolijk
Iemand is een keyboard aan het opbergen	Iemand bergt een keyboard op
De man is brood in sneetjes aan het snijden	De man snijdt brood in sneetjes
Een man is aardappelen in schijfjes aan het snijden	Een man snijdt aardappelen in schijfjes
Een man is aan het skateboarden op een halfpipe	Een man skateboardt op een halfpipe
Een auto is risicovol over een meisje aan het springen	Een auto springt risicovol over een meisje
Een kleine groep mensen is aan het wachten om in een restaurant te eten	Een kleine groep mensen wacht om in een restaurant te eten
Een hond is opgewonden aan het spelen met water in een veld	Een hond speelt opgewonden met water in een veld
Een bulldog is de aap aan het borstelen	Een bulldog borstelt de aap
De persoon is uien in schijfjes aan het snijden	De persoon snijdt uien in schijfjes
Twee vrouwen zijn aan het praten	Twee vrouwen praten
De dame is een ei aan het kraken voor de mixer	De dame kraakt een ei voor de mixer
Een persoon is aan het dansen	Een persoon danst
De man is voorzichtig een stenograaf aan het bedienen	De man bedient voorzichtig een stenograaf
Sommige oude vrouwen zijn aan het praten	Sommige oude vrouwen praten
Twee kinderen zijn aan het voetballen in het park	Twee kinderen voetballen in het park
Iemand is een tomaat in schijfjes aan het snijden	Iemand snijdt een tomaat in schijfjes
Een vrouw is een vis aan het doorsnijden	Een vrouw snijdt een vis door
Iemand is een dier aan het schoonmaken	Iemand maakt een dier schoon
Sommige cheerleaders zijn aan het ontspannen	Sommige cheerleaders ontspannen
Een paar zwemmers zijn aan het racen in een meer	Een paar zwemmers racen in een meer
Een vrouw is een aardappel aan het schillen	Een vrouw schilt een aardappel
Twee mannen zijn aan het boksen	Twee mannen boksen
Twee mensen zijn aan het knokken in een ring	Twee mensen knokken in een ring
Een vrouw is een varkenskotelet aan het paneren	Een vrouw paneert een varkenskotelet
Sommige kittens zijn aan het eten	Sommige kittens eten
Een bruine hond en een zwarte hond zijn aan het dartelen in het zand	Een bruine hond en een zwarte hond dartelen in het zand
Een man is boter aan het hakken in een container	Een man hakt boter in een container
Een vrouw is van een reling af aan het snowboarden in de sneeuw	Een vrouw snowboardt van een reling af in de sneeuw
Twee basketbalspelers zijn aan het klauteren voor de bal op het veld	Twee basketbalspelers klauteren voor de bal op het veld
Een kind in een rode outfit is gevaarlijk aan het springen op een trampoline	Een kind in een rode outfit springt gevaarlijk op een trampoline
Twee honden zijn aan het dartelen in de sneeuw	Twee honden dartelen in de sneeuw
De jongen in de blauwe overall is aan het schilderen	De jongen in de blauwe overall schildert
Een vrouw is tofu in schijfjes aan het snijden	Een vrouw snijdt tofu in schijfjes
Twee welpen zijn aan het spelen	Twee welpen spelen
Een hond is een stok aan het halen uit zeer helder water	Een hond haalt een stok uit zeer helder water
Een meisje is haar nagels aan het vijlen	Een meisje vijlt haar nagels
Een man is een wapen aan het slijpen	Een man slijpt een wapen
Een vrouw is de aardappel aan het schillen	Een vrouw schilt de aardappel
Een man is aan het lunchen	Een man luncht
De bruine honden zijn speels aan het vechten op het zandstrand	De bruine honden vechten speels op het zandstrand
Een persoon is een reling af aan het snowboarden in de sneeuw	Een persoon snowboardt een reling af in de sneeuw
Eén vis is aan het zwemmen	Eén vis zwemt
Iemand is aan het schrijven	Iemand schrijft
Twee honden zijn aan het vechten	Twee honden vechten
Een hond is opgewonden aan het spelen met water in het gras	Een hond speelt opgewonden met water in het gras
Twee mensen zijn aan het kickboksen en toeschouwers kijken niet	Twee mensen kickboksen en toeschouwers kijken niet
De vrouw is een fluit aan het opbergen	De vrouw bergt een fluit op
Een man is een schoen aan het vastbinden	Een man bindt een schoen vast
Een persoon is een ui aan het inpakken	Een persoon pakt een ui in
Een kleine zwart-witte hond draagt een stok en is aan het zwemmen	Een kleine zwart-witte hond draagt een stok en zwemt
Twee mannen zijn aan het racen in een bandenrolwedstrijd	Twee mannen racen in een bandenrolwedstrijd
De hond is aan het uitrusten in het park	De hond rust uit in het park
Een bij is aan het opstijgen van een gele bloem	Een bij stijgt op van een gele bloem
Een dier is aan het rusten	Een dier rust
Twee honden zijn vrolijk samen aan het spelen op het gras	Twee honden spelen vrolijk samen op het gras
Iemand is een cameralens aan het spijkeren met luide knallen	Iemand spijkert een cameralens met luide knallen
Iemand is een stuk papier aan het vouwen	Iemand vouwt een stuk papier
Een wandelaar is op de top van de berg en is aan het dansen	Een wandelaar is op de top van de berg en danst
Drie jongens in karatekostuums zijn aan het vechten	Drie jongens in karatekostuums vechten
Een paar politievrouwen zijn aan het zingen	Een paar politievrouwen zingen
Een man is aan het touwtje springen in een veld	Een man springt touwtje in een veld
Een vrouw is een vis aan het uitbenen	Een vrouw beent een vis uit
De man is een tomaat in schijfjes aan het snijden	De man snijdt een tomaat in schijfjes
Een baby is vrolijk aan het waggelen	Een baby waggelt vrolijk
Vrouwen zijn houtblokken aan het zagen	Vrouwen zagen houtblokken
De bruine honden zijn speels aan het vechten op de zandkust	De bruine honden vechten speels op de zandkust
Een persoon is een ui in elkaar aan het knutselen	Een persoon knutselt een ui in elkaar
Drie vrouwen zijn aan het dansen	Drie vrouwen dansen
Een meisje is aan het sporten	Een meisje sport
Een vrouw is buiten aan het touwtje springen	Een vrouw springt buiten touwtje
De man is aan het zwemmen in een waterlichaam bij een waterval	De man zwemt in een waterlichaam bij een waterval
Een grote hond en een kleine hond staan naast het keukenaanrecht en zijn aan het snuffelen	Een grote hond en een kleine hond staan naast het keukenaanrecht en snuffelen
De dame is de aardappel aan het schillen	De dame schilt de aardappel
Sommige mannen zijn aan het rusten	Sommige mannen rusten
Een man is een broodje in sneetjes aan het snijden	Een man snijdt een broodje in sneetjes
Sommige cheerleaders zijn aan het dansen	Sommige cheerleaders dansen
Iemand is wat papier aan het knippen met een schaar	Iemand knipt wat papier met een schaar
Een vrouw is het water uit een mok aan het legen	Een vrouw leegt het water uit een mok
De man is afwezig een banaan bij een boom aan het eten	De man eet afwezig een banaan bij een boom
Een vrouw is wat eten aan het bakken	Een vrouw bakt wat eten
Iemand is een kat aan het borstelen	Iemand borstelt een kat
Het meisje is aan het loungen	Het meisje lounget
Eén panda is aan het klimmen	Eén panda klimt
De man is een papieren bord aan het snijden	De man snijdt een papieren bord
Een man is aan het rusten	Een man rusten
Twee mannen zijn aan het praten	Twee mannen praten
Een man is de gitaar aan het inpakken	Een man pakt de gitaar in
Een groep mensen is aan het dansen	Een groep mensen danst
Een vrouw is knoflook in stukken aan het hakken	Een vrouw hakt knoflook in stukken
Een zwart topless persoon is een stapel stenen aan het inpakken en er is een wolkenfront op de achtergrond	Een zwart topless persoon pakt een stapel stenen in en er is een wolkenfront op de achtergrond
Twee mensen in twee stoelen zijn aangenaam aan het lezen	Twee mensen in twee stoelen lezen aangenaam
De gespierde man is aan het dansen en de man achter hem draagt groene kralen	De gespierde man danst en de man achter hem draagt groene kralen
Een machine is een mes aan het slijpen	Een machine slijpt een mes
Een man is een ui in schijfjes aan het snijden	Een man snijdt een ui in schijfjes
Een man is hersenloos de wortel in schijfjes aan het snijden met een machine	Een man snijdt hersenloos de wortel in schijfjes met een machine
Een paard is aan het racen	Een paard racet
Een vrouw is een rode ui aan het hakken	Een vrouw hakt een rode ui
Een leeuw is de hele pen aan het vermoeien door te stappen	Een leeuw vermoeit de hele pen door te stappen
Een vrouw is een ui aan het hakken	Een vrouw hakt een ui
Een man is van een reling af aan het snowboarden in de sneeuw	Een man snowboardt van een reling af in de sneeuw
Een man is een container van plastic volledig aan het legen	Een man leegt een container van plastic volledig
Iemand is iets aan het noteren met een potlood	Iemand noteert iets met een potlood
Een persoon is een stuk papier aan het vouwen	Een persoon vouwt een stuk papier
Een meisje is aan het skateboarden op een halfpipe	Een meisje skateboardt op een halfpipe
Een vrouw is vlees aan het snijden	Een vrouw snijdt vlees
Een das, die sluw is, is de aarde aan het graven	Een das, die sluw is, graaft de aarde
De man is wat aardappelen in schijfjes aan het snijden	De man snijdt wat aardappelen in schijfjes
Een grote hond en een kleine witte hond zijn samen aan het spelen	Een grote hond en een kleine witte hond spelen samen
Twee mensen in twee stoelen zijn aan het lezen	Twee mensen in twee stoelen lezen
Een jongen is aan het skateboarden op een halfpipe	Een jongen skateboardt op een halfpipe
Een man is een uitgesneden doos aan het plakken	Een man plakt een uitgesneden doos
Een man is aan het luieren	Een man luiert
Een blond meisje is aan het surfen	Een blond meisje surft
Een vrouw is een aubergine in schijfjes aan het snijden	Een vrouw snijdt een aubergine in schijfjes
Een man is vlug wat champignons aan het hakken met een mes	Een man hakt vlug wat champignons met een mes
Sommige vrouwen zijn aan het praten	Sommige vrouwen praten
Een man is gras aan het maaien	Een man maait gras
Een kind is aan het buikschuiven in het gras	Een kind buikschuift in het gras
Een vrouw is wat vlees in plakjes aan het snijden	Een vrouw snijdt wat vlees in plakjes
Een persoon is snel champignons aan het hakken met een mes	Een persoon hakt snel champignons met een mes
Een klein kind is buiten op de trap aan het klimmen in een grasveld	Een klein kind klimt buiten op de trap in een grasveld
Twee honden zijn binnen aan het spelen	Twee honden spelen binnen
De man is aan het vasten	De man vast
Twee voetballers zijn aan het klauteren voor de bal op het veld	Twee voetballers klauteren voor de bal op het veld
De mannen zijn aan het praten	De mannen praten
Een man is atletisch op een muur aan het springen	Een man springt atletisch op een muur
Een kat is aan het spelen met een watermeloen	Een kat speelt met een watermeloen
Een persoon is een ui aan het schillen	Een persoon schilt een ui
Een meisje is twee stukken boter aan het smelten	Een meisje smelt twee stukken boter
Een man is een container van plastic aan het legen	Een man leegt een container van plastic
De man is onhandig met een trainer aan het kickboksen	De man kickbokst onhandig met een trainer
Een vrouw is aan het telefoneren	Een vrouw telefoneert
De das is een gat aan het graven	De das graaft een gat
Iemand die aan het snowboarden is, springt in de lucht	Iemand die snowboardt, springt in de lucht
Een vrouw is een octopus in schijfjes aan het snijden	Een vrouw snijdt een octopus in schijfjes
Een vrouw is aan het frituren	Een vrouw frituurt
De man is een aardappel aan het inpakken	De man pakt een aardappel in
De man en de vrouw zijn aan het wandelen	De man en de vrouw wandelen
De man is aan het typen op een machine die gebruikt wordt voor stenografie	De man typet op een machine die gebruikt wordt voor stenografie
Twee mannen zijn aan het strijden	Twee mannen strijden
De man is de worsten aan het kruiden	De man kruidt de worsten
Drie jongens in karate uniform zijn aan het sparren	Drie jongens in karate uniform sparren
Mannen zijn hout aan het snijden	Mannen snijden hout
Een man is een grote biefstuk aan het afspoelen	Een man spoelt een grote biefstuk af
Drie Aziatische kinderen zijn aan het dansen en een man kijkt	Drie Aziatische kinderen dansen en een man kijkt
De persoon is snel een groente in schijfjes aan het snijden	De persoon snijdt snel een groente in schijfjes
Een vrouw is langzaam een aardappel aan het schillen	Een vrouw schilt langzaam een aardappel
Twee mannen in een race zijn de banden van een tractor aan het omdraaien	Twee mannen in een race draaien de banden van een tractor om
Een vrouw is knoflook aan het hakken	Een vrouw hakt knoflook
De persoon is aan het schilderen	De persoon schildert
Twee vrouwen dragen bikini's en zijn op het zand aan het lopen	Twee vrouwen dragen bikini's en lopen op het zand
Een man is een stenograafmachine aan het opbergen	Een man bergt een stenograafmachine op
Een man is een vis aan het doorsnijden	Een man snijdt een vis door
Een man is een akoestische gitaar aan het opbergen	Een man bergt een akoestische gitaar op
Een zwarte man is aan het breakdansen op de stoep	Een zwarte man breakdanst op de stoep
Het meisje in een blauwe overall is aan het schilderen	Het meisje in een blauwe overall schildert
Twee grote honden zijn aan het stoeien in een veld	Twee grote honden stoeien in een veld
Een man is langzaam aan het wandelen in het bos	Een man wandelt langzaam in het bos
De vrouwen zijn goddelijk aan het dansen buiten	De vrouwen dansen goddelijk buiten
Een man is boter aan het hakken in een klein bakje	Een man hakt boter in een klein bakje
Een man is boter in plakjes aan het snijden	Een man snijdt boter in plakjes
De persoon is een kat aan het borstelen	De persoon borstelt een kat
De man is een aardappel in schijfjes aan het snijden	De man snijdt een aardappel in schijfjes
Een kerel is vrolijk aan het spelen met de hacky sack	Een kerel speelt vrolijk met de hacky sack
Een man in een rood uniform is aan het racen en maakt een sprong over een fiets in het zand	Een man in een rood uniform racet en maakt een sprong over een fiets in het zand
Een persoon is een ui in schijfjes aan het snijden	Een persoon snijdt een ui in schijfjes
Een vrouw is aan het tornen met een machine	Een vrouw tornt met een machine
De man is de tekening op het bord aan het uitwissen	De man wist de tekening op het bord uit
Drie mannen zijn aan het dansen	Drie mannen dansen
Een jongen is zijn haar aan het stylen	Een jongen stylet zijn haar
Een man is aan het wandelen in het bos	Een man wandelt in het bos
Een zwarte hond en een witte hond zijn aan het worstelen op het bed	Een zwarte hond en een witte hond worstelen op het bed
De rijders zijn aan het schermen in een metalen jongensfiets	De rijders schermen in een metalen jongensfiets
Een vrouw is voedsel aan het schillen	Een vrouw schilt voedsel
De chef is de olie aan het kruiden	De chef kruidt de olie
Twee teams zijn enthousiast aan het voetballen	Twee teams voetballen enthousiast
Een vrouw is een groente in schijfjes aan het snijden	Een vrouw snijdt een groente in schijfjes
Een kleine hond is aan het vertragen en de eigenaar stopt met hem achtervolgen	Een kleine hond vertraagt en de eigenaar stopt met hem achtervolgen
Een persoon is een jasje aan het cementeren in een blauwe hoge muur en aan het springen	Een persoon cementeert een jasje in een blauwe hoge muur en springt
Het meisje is het werk van de andere man van het bord aan het wissen	Het meisje wist het werk van de andere man van het bord
Een man is een aardappel in schijfjes aan het snijden	Een man snijdt een aardappel in schijfjes
Twee mannen zijn aan het vechten	Twee mannen vechten
De mannen zijn aan het knokken in een ring	De mannen knokken in een ring
Twee jonge kinderen zijn aan het vasten	Twee jonge kinderen vasten
Een man is aan het rennen	Een man rent
Twee sumoworstelaars zijn aan het vechten	Twee sumoworstelaars vechten
Iemand is een rode ui aan het hakken	Iemand hakt een rode ui
Een vrouw is knoflook in schijfjes aan het snijden	Een vrouw snijdt knoflook in schijfjes
De dame is een tomaat in schijfjes aan het snijden	De dame snijdt een tomaat in schijfjes
De vrouw is een aardappel aan het schillen	De vrouw schilt een aardappel
Een vrouw is aan het sporten	Een vrouw sport
De baby is vrolijk aan het kruipen	De baby kruipt vrolijk
Een groep mannen is aan het vechten	Een groep mannen vecht
Een snowboarder is van een een lange reling af aan het schuren	Een snowboarder schuurt van een een lange reling af
Twee toeschouwers zijn aan het kickboksen en sommige mensen kijken toe	Twee toeschouwers kickboksen en sommige mensen kijken toe
Een vrouw is een ham aan het kruiden	Een vrouw kruidt een ham
De dame is het vlees in plakjes aan het snijden	De dame snijdt het vlees in plakjes
Een persoon is een komkommer in schijfjes aan het snijden	Een persoon snijdt een komkommer in schijfjes
Een kerel is vrolijk aan het spelen met een hacky sack	Een kerel speelt vrolijk met een hacky sack
Twee kinderen zijn aan het strekken op een aantal metalen staven	Twee kinderen strekken op een aantal metalen staven
Een vrouw is afwezig een aardappel aan het schillen	Een vrouw schilt afwezig een aardappel
De speler is de basketbal in het net aan het dunken en er is een menigte op de achtergrond	De speler dunkt de basketbal in het net en er is een menigte op de achtergrond
De vrouw is knoflook aan het hakken	De vrouw hakt knoflook
Twee vrouwen zijn aan het sparren in een kickbokswedstrijd	Twee vrouwen sparren in een kickbokswedstrijd
Een vrouw in een rode jurk is een instrument aan het opbergen	Een vrouw in een rode jurk bergt een instrument op
De kat is aan het spelen met een watermeloen	De kat speelt met een watermeloen
Het dier met de grote ogen is gulzig aan het eten	Het dier met de grote ogen eet gulzig
De persoon is een groente in schijfjes aan het snijden	De persoon snijdt een groente in schijfjes
Een vrouw is uien aan het hakken	Een vrouw hakt uien
De vrouw is de olie aan het kruiden	De vrouw kruidt de olie
De dame is uien aan het snijden	De dame snijdt uien
Twee grote honden zijn aan het dartelen in een grasveld	Twee grote honden dartelen in een grasveld
Twee vrouwen zijn lekker aan het dansen	Twee vrouwen dansen lekker
Twee mannen zijn aan het knuffelen	Twee mannen knuffelen
Een man is een aardappel aan het hakken	Een man hakt een aardappel
Het meisje in de blauwe overall is aan het schilderen	Het meisje in de blauwe overall schildert
Een man is een plastic container aan het legen	Een man leegt een plastic container
Een vrouw is voorzichtig haar make-up aan het verwijderen	Een vrouw verwijdert voorzichtig haar make-up
Iemand is aan het typen	Iemand is typet
De hond is aan het uitrusten in de woonkamer	De hond rust uit in de woonkamer
Een paar kittens zijn aan het eten	Een paar kittens eten
Twee poedels liggen in de sneeuw en één is aan het springen	Twee poedels liggen in de sneeuw en één springt
Een man is een zittende gitarist aan het vloeren	Een man vloert een zittende gitarist
Sommige mannen zijn aan het vechten	Sommige mannen vechten
Iemand is een banaan aan het schillen	Iemand schilt een banaan
Twee preadolescente tweelingkinderen zijn aan het duelleren met stokken	Twee preadolescente tweelingkinderen duelleren met stokken
Een man is uien in schijfjes aan het snijden	Een man snijdt uien in schijfjes
Een groep honden is woedend aan het racen en heeft muilkorven op de neuzen	Een groep honden racet woedend en heeft muilkorven op de neuzen
Twee mensen in een race zijn de banden van een tractor aan het omdraaien	Twee mensen in een race draaien de banden van een tractor om
De lopers zijn aan het racen in een wedstrijd	De lopers racen in een wedstrijd
Twee mensen in twee stoelen zijn aan het praten	Twee mensen in twee stoelen praten
Een paar mannen zijn aan het dansen	Een paar mannen dansen
Sommige vrouwen zijn vrolijk aan het dansen	Sommige vrouwen dansen vrolijk
Een baby is vrolijk aan het spelen met een hond	Een baby speelt vrolijk met een hond
De vrouw is de tekening op het bord aan het uitwissen	De vrouw wist de tekening op het bord uit
Een man is aan het bidden	Een man bidt
Een man is een ui aan het schillen	Een man schilt een ui
De man is aan het trainen	De man traint
De jongen en het meisje zijn vrolijk aan het spelen en dragen zwembandjes	De jongen en het meisje spelen vrolijk en dragen zwembandjes
Twee jonge vrouwen zijn aan het sparren in een kickboksgevecht	Twee jonge vrouwen sparren in een kickboksgevecht
Twee mensen zijn aan het kickboksen en toeschouwers kijken toe	Twee mensen kickboksen en toeschouwers kijken toe
Een vrouw is vis aan het bakken	Een vrouw bakt vis
Twee mensen zijn aan het vechten en toeschouwers kijken toe	Twee mensen vechten en toeschouwers kijken toe
Een vrouw is een vis voorzichtig aan het uitbenen	Een vrouw beent een vis voorzichtig uit
Een Aziatische man is aan het dansen en drie kinderen kijken	Een Aziatische man danst en drie kinderen kijken
Een paar vrouwen zijn aan het dansen	Een paar vrouwen dansen
De vrouw is een ui in schijfjes aan het snijden	De vrouw snijdt een ui in schijfjes
Iemand is de ingrediënten aan het bowlen naar de man bij de mixer	Iemand bowlt de ingrediënten naar de man bij de mixer
De aap is een bulldog aan het borstelen	De aap borstelt een bulldog
De dame is een ei aan het breken voor de mixer	De dame breekt een ei voor de mixer
Een panda is aan het klimmen	Een panda klimt
Drie Aziatische kinderen zijn aan het dansen en een serieuze man kijkt	Drie Aziatische kinderen dansen en een serieuze man kijkt
Mannen zijn aan het zagen	Mannen zagen
Een bruine en witte hond is aan het rusten in het gras	Een bruine en witte hond rust in het gras
Twee katten zijn speels aan het vechten met elkaar	Twee katten vechten speels met elkaar
Een dame is wat vlees aan het snijden	Een dame snijdt wat vlees
Een maki is aan het eten	Een maki eet
Iemand is een piano aan het demonteren	Iemand demonteert een piano
Een baby is vrolijk aan het kruipen	Een baby kruipt vrolijk
Een man is eten aan het bakken	Een man bakt eten
Een bruine en witte hond met een bruine en zwarte bandana is snel aan het rennen	Een bruine en witte hond met een bruine en zwarte bandana rent snel
De vrouw is geen knoflook in blokjes aan het snijden	De vrouw snijdt geen knoflook in blokjes
Twee mensen zijn aan het praten	Twee mensen praten
Het meisje is aan het draven op het paard	Het meisje draaft op het paard
Iemand is aan het typen op een toetsenbord	Iemand typet op een toetsenbord
Iemand is aan het typen op het toetsenbord	Iemand typet op het toetsenbord
Een man is een mes aan het slijpen	Een man slijpt een mes
Een jongen is aan het buikschuiven in het gras	Een jongen buikschuift in het gras
Twee mannen zijn aan het raften in de buurt van een ruiter in het oranje op de oever	Twee mannen raften in de buurt van een ruiter in het oranje op de oever
Sommige mannen zijn aan het zagen	Sommige mannen zagen
Een persoon is aan het sporten	Een persoon sport
Iemand is stevig eieren in een kom aan het kloppen	Iemand klopt stevig eieren in een kom
Twee grote honden zijn aan het dartelen op een parkeerplaats	Twee grote honden dartelen op een parkeerplaats
Er is geen man die aan het mixen is	Er is geen man die mixt
Het meisje is aan het sporten	Het meisje sport
Een meisje met rood haar en rode wenkbrauwen is aan het spreken	Een meisje met rood haar en rode wenkbrauwen spreekt
De vrouw is een babykangoeroe aan het oppakken en vasthouden	De vrouw pakt een babykangoeroe op en houdt deze vast
Drie jonge mannen zijn woedend aan het rennen, springen en schoppen in de buurt van een verkoopautomaat	Drie jonge mannen rennen, springen en schoppen woedend in de buurt van een verkoopautomaat
Een vrouw is een hond aan het aaien in de buurt van een stenen pad	Een vrouw aait een hond in de buurt van een stenen pad
Twee jongens zijn aan het studeren	Twee jongens studeren
Een vrouw is een komkommer in schijfjes aan het snijden	Een vrouw snijdt een komkommer in schijfjes
Een vrouw is aardappelen in schijfjes aan het snijden	Een vrouw snijdt aardappelen in schijfjes
Een persoon is een vel aan het vouwen	Een persoon vouwt een vel
Een verre persoon met een blauwe rugzak is aan het wandelen in rotsachtig gebied	Een verre persoon met een blauwe rugzak wandelt in rotsachtig gebied
Een man is aan het mixen	Een man mixt
De man is de tape op de doos aan het knippen	De man knipt de tape op de doos
Een vrouw is boter in plakjes aan het snijden	Een vrouw snijdt boter in plakjes
De man is het werk van de andere man van het bord aan het wissen	De man wist het werk van de andere man van het bord
Een hond is aan het rennen	Een hond rent
Twee witte honden zijn aan het rennen en springen langs een strand	Twee witte honden rennen en springen langs een strand
De man is het vlees aan het kruiden	De man kruidt het vlees
Een vis is aan het zwemmen	Een vis zwemt
Een zwarte man is vakkundig op de stoep aan het breakdansen	Een zwarte man breakdanst vakkundig op de stoep
De man is de aardappel in schijfjes aan het snijden	De man snijdt de aardappel in schijfjes
Een zwarte hond en een bruingele hond zijn aan het vechten	Een zwarte hond en een bruingele hond vechten
De vrouw is kruiden aan het snijden	De vrouw snijdt kruiden
De bruine hond en de rode hond zijn aan het dartelen op het strand	De bruine hond en de rode hond dartelen op het strand
Een kleine jongen is een hond aan het uitschelden	Een kleine jongen scheldt een hond uit
Een man met een helm is aan het dansen	Een man met een helm is aan het dansen
De vrouw is aan het waterskiën	De vrouw waterskiet
De man is aardappelen in schijfjes aan het snijden	De man snijdt aardappelen in schijfjes
Een man is wat cijfers aan het wissen	Een man wist wat cijfers
Een man is langzaam aan het dansen op de weg	Een man danst langzaam op de weg
Een vrouw is vlees aan het bakken	Een vrouw bakt vlees
De jongen is aan het draven op het paard	De jongen draaft op het paard
De vrouw is een wortel in blokjes aan het snijden	De vrouw snijdt een wortel in blokjes
Een man is een ui aan het hakken	Een man hakt een ui
Een persoon is een ui aan het hakken	Een persoon hakt een ui
Een meisje is haar haar aan het stylen	Een meisje stylet haar haar
Een vrouw is een aardappel aan het wegzetten	Een vrouw zet een aardappel weg
Een man met een trui is de bal aan het dunken bij een basketbalwedstrijd	Een man met een trui dunkt de bal bij een basketbalwedstrijd
Een hond is een stuk hout aan het halen uit zeer helder water	Een hond haalt een stuk hout uit zeer helder water
De persoon is een ui aan het schillen	De persoon schilt een ui
Iemand die aan het voetballen is draagt zwarte armbanden	Iemand die voetbalt draagt zwarte armbanden
Een grote zwart-witte hond draagt een stok en is aan het zwemmen	Een grote zwart-witte hond draagt een stok en zwemt
Twee mannen zijn aan het knokken in een ring	Twee mannen knokken in een ring
Een zwarte hond en een gele hond zijn met elkaar aan het spelen	Een zwarte hond en een gele hond spelen met elkaar
Een vrouw is aan het wakeboarden op een meer	Een vrouw wakeboardt op een meer
De persoon is de aardappel in schijfjes aan het snijden	De persoon snijdt de aardappel in schijfjes
De man is een boomstam aan het hakken met een bijl	De man hakt een boomstam met een bijl
De vrouw is onbevreesd aan het waterskiën	De vrouw waterskiet onbevreesd
De dame is eieren die rauw zijn aan het breken in een kom	De dame breekt eieren die rauw zijn in een kom
Een man is buiten aan het touwtje springen	Een man springt buiten touwtje
Twee meisjes zijn gelukkig aan het spelen in een springkasteel	Twee meisjes spelen gelukkig in een springkasteel
Een man is aan het racen	Een man racet
Iemand is een dier aan het bevuilen	Iemand bevuilt een dier
Een vrouw is een ui in schijfjes aan het snijden	Een vrouw snijdt een ui in schijfjes
De man is wild aan het dansen	De man danst wild aan het dansen
De zwart-witte hond is aan het rennen en er staat een persoon achter	De zwart-witte hond rent en er staat een persoon achter
De persoon is aan het wandelen	De persoon wandelt
Een man is deeg aan het kneden	Een man kneedt deeg
Twee honden zijn aan het worstelen en knuffelen	Twee honden worstelen en knuffelen
De man is voorzichtig een muis aan de slang aan het voeden	De man voedt voorzichtig een muis aan de slang
De vrouw is knoflook in schijfjes aan het snijden	De vrouw snijdt knoflook in schijfjes
Eén man is aan het dansen	Eén man danst
Een man is aan het sporten	Een man sport
Een bruine hond en een rode hond zijn op het strand aan het dartelen	Een bruine hond en een rode hond dartelen op het strand
Een vrouw is aan het wakeboarden op het meer	Een vrouw wakeboardt op het meer
Een dame is precies wat vlees aan het snijden	Een dame snijdt precies wat vlees
Een man is de schoen aan het vastbinden	Een man bindt de schoen vast
De vrouw is een tomaat in schijfjes aan het snijden	De vrouw snijdt een tomaat in schijfjes
Een man is tomaten in schijfjes aan het snijden	Een man snijdt tomaten in schijfjes
Een vrouw is iets aan het bakken	Een vrouw bakt iets
Een motorfiets is rechtop aan het rijden op het zadel van het voertuig	Een motorfiets rijdt rechtop op het zadel van het voertuig
De man is groenten in schijfjes aan het snijden	De man snijdt groenten in schijfjes
Een man is een jachtgeweer aan het herladen	Een man herlaadt een jachtgeweer
De hond met de bruine vacht is buiten aan het spelen	De hond met de bruine vacht speelt buiten
De man is aan het wandelen in het bos	De man wandelt in het bos
Twee lange basketbalspelers zijn aan het klauteren voor de bal op het veld	Twee lange basketbalspelers klauteren voor de bal op het veld
Het meisje zit op de bank en is aan het haken	Het meisje zit op de bank en haakt
De mannen zijn koffers aan het inpakken in de kofferbak van een auto	De mannen pakken koffers in in de kofferbak van een auto
Een vrouw is aan het surfen	Een vrouw surft
Eén persoon die snowboarden aan het oefenen is, springt in de lucht	Eén persoon die snowboarden oefent, springt in de lucht
Een vrouw is een stuk vlees aan het kruiden	Een vrouw kruidt een stuk vlees
